

		NO ./path_to_the_north_texture.texture

F              0,100,33
SO ./path_to_the_south_texture.texture
WE 	./path_to_the_west_texture.texture


EA ./path_to_the_east_texture.texture
C   225,30,33

1111111111111111111111111                       1111111111
111000000011000000000001                        10000000001
1011000001110000000000001                       00000000000
110100000000000000000000111111111
111111111011000001110000000000001
100000000011000001110111111111111
11110111111111011100000010001
11110111111111011101010010001
1100000011010101110000001000111
1000000000001  1001100000010001
1000000000000100010101001000111
11000001110101011111011110N0111
11110111 1110101 101111010001
11111111 1111111 111111111111